2111111111121111111111112
1000000000000000000000001
1000000000001000000000001
1000000000001000000000001
1000000000001000000000001
1000000001112111000000001
1000000000001000000000001
1000000000001000000000001
1000000000001000000000001
1000010000000000000100001
1000010000000000000100001
1000010000000000000100001
2011121110001000111211102
1000010000000000000100001
1000010000000000000100001
1000010000000000000100001
1000000000001000000000001
1000000000001000000000001
1000000000001000000000001
1000000001112111000000001
1000000000001000000000001
1000000000001000000000001
1000000000001000000000001
1000000000000000000000001
2111111111121111111111112
